NO ./img/NO.xpm
SO ./img/SO.xpm
WE ./img/WE.xpm
EA ./img/EA.xpm
F 00,153,15
C 255,255,255

11111
10N01
10001
11111