NO ./images/NO.xpm
SO ./images/SO.xpm
WE ./images/WE.xpm
EA ./images/EA.xpm
F 110,153,15 
C 255,255,255


111111111111111111111111111111111
111111111000000000000000000000001
111111111100000000000000000000001
111111111000000000000000000000001
111111111000000000000000000000001
10000000000000N000000000000001111
100000000000000000000000000011111
000000000000000000000000000011111
100000000000000000000000100011111
100000000000000000000000000011111
100000000000000000010100000011111
110000001101010111101111010111111
111101101111011111011110100011111
111111111111111111111111111111111




